+++++++++++++
+   0    *Aa+
+ +++++++++ +
+           +
+++++++++++++
